key	text	tooltip
#Loc;1;text/db/ovn_dread_king_only_building_culture_variants.loc		
building_culture_variants_name_dread_pyramid_omanhan_landmarkovn_tmb_dread_king	Pyramid of King Omanhan III	true
building_culture_variants_name_dread_pyramid_nebwaneph_landmarkovn_tmb_dread_king	Pyramid of King Nebwaneph	true
building_culture_variants_name_dread_pyramid_dread_king_landmarkovn_tmb_dread_king	The Twisted Spire	true
building_culture_variants_name_dread_palace_myrmidens_landmarkovn_tmb_dread_king	Palace of Myrmidens	true
building_culture_variants_name_dread_temple_of_doom_landmarkovn_tmb_dread_king	Temple of Doom	true
building_culture_variants_name_dread_infantry_1ovn_tmb_dread_king	Open Graves	true
building_culture_variants_name_dread_infantry_2ovn_tmb_dread_king	Crypt Barracks	true
building_culture_variants_name_dread_infantry_3ovn_tmb_dread_king	Stratopedon	true
building_culture_variants_name_dread_infantry_4ovn_tmb_dread_king	Royal Barracks	true
building_culture_variants_name_dread_cavalry_1ovn_tmb_dread_king	Quicksand Swamp	true
building_culture_variants_name_dread_cavalry_2ovn_tmb_dread_king	Ancient Battle Site	true
building_culture_variants_name_dread_cavalry_3ovn_tmb_dread_king	Royal Menagerie	true
building_culture_variants_name_dread_burial_moundovn_tmb_dread_king	Grave Hill	true
building_culture_variants_name_dread_burial_mound_2ovn_tmb_dread_king	Ancient Burial Mound	true
building_culture_variants_name_wh2_dlc09_tmb_infantry_1ovn_tmb_dread_king	Open Graves	true
building_culture_variants_name_wh2_dlc09_tmb_infantry_2ovn_tmb_dread_king	Crypt Barracks	true
building_culture_variants_name_wh2_dlc09_tmb_infantry_3ovn_tmb_dread_king	Royal Barracks	true
building_culture_variants_name_wh2_dlc09_tmb_cavalry_1ovn_tmb_dread_king	Quicksand Swamp	true
building_culture_variants_name_wh2_dlc09_tmb_cavalry_2ovn_tmb_dread_king	Ancient Battle Site	true
building_culture_variants_name_wh2_dlc09_tmb_cavalry_3ovn_tmb_dread_king	Necroserpent Nest	true
building_culture_variants_name_wh2_dlc09_tmb_cavalry_4ovn_tmb_dread_king	Royal Menagerie	true
building_culture_variants_name_dread_ghosts_1ovn_tmb_dread_king	Spirit Well	true
building_culture_variants_name_dread_ghosts_2ovn_tmb_dread_king	Font of Nightmares	true
building_culture_variants_name_dread_elephants_1ovn_tmb_dread_king	Elephant Graveyard	true
building_culture_variants_name_dread_hydras_1ovn_tmb_dread_king	Hydra Lair	true
building_culture_variants_name_dread_colossus_1ovn_tmb_dread_king	Colossal Bones	true
building_culture_variants_name_dread_mortis_1ovn_tmb_dread_king	Forbidden Library	true
building_culture_variants_name_wh2_dlc09_tmb_hierotitan_1ovn_tmb_dread_king	Restored Hierotitan Statue	true
building_culture_variants_name_wh2_dlc09_tmb_necrosphinx_1ovn_tmb_dread_king	Restored Necrosphinx Statue	true
building_culture_variants_name_wh2_dlc09_tmb_scorpions_1ovn_tmb_dread_king	Scorpion Nest	true
building_culture_variants_name_wh2_dlc09_tmb_ushabti_1ovn_tmb_dread_king	Statuary of Khemri	true
building_culture_variants_name_wh2_dlc09_tmb_ushabti_2ovn_tmb_dread_king	Statue of Phakth	true
building_culture_variants_name_wh2_dlc09_tmb_warsphinx_1ovn_tmb_dread_king	Restored Warsphinx Statue	true
building_culture_variants_name_wh2_dlc09_tmb_settlement_major_1ovn_tmb_dread_king	Ruined Katoika	true
building_culture_variants_name_wh2_dlc09_tmb_settlement_major_2ovn_tmb_dread_king	Haunted Oikismos	true
building_culture_variants_name_wh2_dlc09_tmb_settlement_major_3ovn_tmb_dread_king	Forsaken Polis	true
building_culture_variants_name_wh2_dlc09_tmb_settlement_major_4ovn_tmb_dread_king	Cursed Cleruchy	true
building_culture_variants_name_wh2_dlc09_tmb_settlement_major_5ovn_tmb_dread_king	Necropolis	true
building_culture_variants_name_wh2_dlc09_tmb_settlement_minor_1ovn_tmb_dread_king	Ruined Katoika	true
building_culture_variants_name_wh2_dlc09_tmb_settlement_minor_2ovn_tmb_dread_king	Haunted Oikismos	true
building_culture_variants_name_wh2_dlc09_tmb_settlement_minor_3ovn_tmb_dread_king	Forsaken Polis	true
building_culture_variants_name_dread_citadel_1ovn_tmb_dread_king	Haunted Citadel	true
building_culture_variants_name_dread_estate_1ovn_tmb_dread_king	Defiled Burial Chamber	true
building_culture_variants_name_dread_chariots_1ovn_tmb_dread_king	Bone Shaper	true
building_culture_variants_name_dread_chariots_2ovn_tmb_dread_king	Dark Brass Works	true
building_culture_variants_name_dread_chariots_3ovn_tmb_dread_king	Skull Repository	true
building_culture_variants_name_dread_growth_1ovn_tmb_dread_king	Mortuary House	true
building_culture_variants_name_dread_growth_2ovn_tmb_dread_king	Catacombs	true
building_culture_variants_name_dread_growth_3ovn_tmb_dread_king	Ossuary	true
building_culture_variants_name_dread_income_1ovn_tmb_dread_king	Stoa	true
building_culture_variants_name_dread_income_2ovn_tmb_dread_king	Agora	true
building_culture_variants_name_dread_income_3ovn_tmb_dread_king	Thesaurofylakion 	true
building_culture_variants_name_dread_public_order_1ovn_tmb_dread_king	Ohlos	true
building_culture_variants_name_dread_public_order_2ovn_tmb_dread_king	Naos	true
building_culture_variants_name_dread_public_order_3ovn_tmb_dread_king	Nagash Monument	true
building_culture_variants_name_dread_special_nagashizzar_dread_kingovn_tmb_dread_king	Great Halls of Nagashizzar	true
building_culture_variants_name_wh2_dlc15_special_morgheim_necropolis_tmbovn_tmb_dread_king	Lost Necropolis of Mourkain	true
building_culture_variants_name_wh2_main_special_galbaraz_mourkain_tmb_1ovn_tmb_dread_king	Ruins of Mourkain	true
building_culture_variants_name_dread_special_the_great_desert_dread_king_1ovn_tmb_dread_king	Lost Tomb Excavation	true
building_culture_variants_name_dread_special_the_great_desert_dread_king_2ovn_tmb_dread_king	Lost Tombs	true
building_culture_variants_name_dread_special_galbaraz_mourkain_tmb_1ovn_tmb_dread_king	Ruins of Mourkain	true
